1111111111111111111111111
1200001000000001000000001
1001001001111001001111001
1001000000001000000001001
1111111111111001111111001
1000001000001001000000001
1001111001001111001111001
1000001001000001001001001
1111001001111001001001001
1001000001001000001000001
1001111111001111111001111
1000000000000000000000031
1111111111111111111111111